R   640 480
NO         ./elmo.xpm
SO ./kermit.xpm
WE ./bert.xpm
EA          ./cookie.xpm

S ./barrel.xpm
F  10, 54,      210
C     48,  		    188,    237



1111111111
1000000001
1022222201
1022202201
1022222201
1001222201
1002000001
1111111111

11111111111
10000000001
10000000001
10000111001
10000020001
10000000001
11111111111

     111111111111
     100000000001
     111100011111
        10001     1111
1111111110001     1001
1000000000001     1001111111
1111111111001     1000000001
         1001     1001111111
1111111111001111111001
100000000000000000N001
1111111111111111111111