R 1920 2507
NO  ./elmo.xpm
SO ./kermit.xpm
WE ./bert.xpm
EA ./cookie.xpm

F    			220,   100,   10
C     225,     30, 5

1111111111
10000000S1
1000000001
1000000001
1000000001
1000000001
1000000001
1111111111