R   640 480
NO         ./textures/blue.xpm
SO ./textures/red.xpm
WE ./textures/green.xpm
EA          ./textures/gray.xpm

S ./textures/barrel.xpm
F     174,   118,    166
C  16, 152,      247


1111111
1000001
1000001
1000001
1000001
1000001
1000001
1000001
1000001
1000001
1000001
1000001
1000001
1000001
1000001
1000001
1000001
1000001
1000001
1000001
1000001
1000001
1000001
1000001
1000001
1000001
1000001
1000001
1000001
1000001
1000001
1000001
1000001
100N001
1111111
