R   640 480
SO ./kermit.xpm
WE ./bert.xpm
EA     ./cookie.xpm
NO  ./elmo.xpm

S		./sprite.xpm
F    	10,   54,   210
C     48,     188, 237

1111111111
1000000001
100000S001
1000000001
1000002001
1000002001
1000020001
1000020001
1111111111