R   640 480
NO         ./elmo.xpm
SO ./kermit.xpm
WE ./bert.xpm
EA          ./cookie.xpm

S ./barrel.xpm
F  10, 54,      210
C     48,  		    188,    237



1111111111
1000000001
1022222201
1022202201
1022222201
1001222201
1002000001
1111111111

11111111111
10000000001
10000000001
10000S00001
10000000001
10000000001
11111111111