R   640 480
NO  ./elmo.xpm
SO ./kermit.xpm
WE ./bert.xpm
EA     ./cookie.xpm

S		./barrel.xpm
F    	10,   54,   210
C     48,     188, 237

1111111111
1222200021
122220N001
1222000001
1020002001
1000020001
1000002001
1000000001
1111111111