R   640 480
NO  ./elmo.xpm
SO ./kermit.xpm
WE ./bert.xpm
EA     ./cookie.xpm

S		./barrel.xpm
F    	10,   54,   210
C     48,     188, 237

1111111111
1022222201
102220N201
1022222201
1022222201
1022222201
1022222201
1022222201
1111111111