R   640 480
NO         ./textures/blue.xpm
SO ./textures/red.xpm
WE ./textures/green.xpm
EA          ./textures/gray.xpm

S ./textures/barrel.xpm
F  174,118,166
C  16,152,247


     111111111111
     100000000001
     111100011111
        10001     1111
1111111112001     1001
1000000220001     1001111111
1111111111001     1002000001
         1001     1001111111
1111111111001111111001
10000000000N0000000001
1111111111111111111111