R   640 480
NO         ./elmo.xpm
SO ./kermit.xpm
WE ./bert.xpm
EA          ./cookie.xpm

S ./barrel.xpm
F  10, 54,      210
C     48,  		    188,    237



1111111111
1000000001
1022222201
10222S2201
1022222201
1001222201
1002000001
1111111111

11111111111
12100000001
10000200201
10000222001
10000220001
10000000001
10000000001
10000000001
10000000001
10000000001
10000000001
11111111111

     111111111111
     100000000001
     111100011111
        10001     1111
1111111110001     1001
1000000000001     1001111111
1111111111001     1000000001
         1001     1001111111
1111111111001111111001
1000000000000000000001
1111111111111111111111